Week,Run,Pass,Yards,WinLoss,Color,Score
1,194,199,393,W,green,40
2,203,210,413,W,green,28
3,196,185,381,W,green,33
4,194,199,393,W,green,34
5,164,174,338,L,red,19
6,159,161,320,L,red,24
7,164,174,338,W,green,30
8,163,174,337,L,red,24
9,164,174,338,W,green,26
10,205,228,433,L,red,32
11,168,174,342,W,green,24
13,163,168,331,W,green,40
14,196,185,381,W,green,23
15,159,161,320,W,green,23
16,163,168,331,W,green,26
17,144,130,274,W,green,31